111111111111111111111
1C0000CCCC0000001
1000101000000001C0011
1P0011100000000CCCC01
111111111111111