1111111111111111111111
10E0000000000000C00001
10C100000000000C000001
1000000000000000000001
1000C0000000000C000011
1000000000000000000001
10000000000C0000000C01
1P00000000000000000001
1111111111111111111111