1111111111
1010101001
1000101001
1010P01101
1001C00001
1010E11101
1001000101
1001100101
1000000001
1111111111