1111111111
101C101001
1000101001
1010P01101
1001000001
1010E11101
1001000101
1001100101
10C0000001
1111111111