11111111111111111111111111111111111111111111111
10E00000000000000000000000000000000000000C00001
10C10000000000000000000000C0000000000000C000001
10000000000000000000000000000000C00000001000001
1000C0000000000C0000101010101000000000000000011
10000000000000000000000000010000000000000000001
10000000000C0000000C011111111111111111111111111
1000C0000000000C0000000000000000000000111111011
10000000000000000000000000000000000000000000001
10000000000C0000000C01000000000C0000000C0111111
1000C0000000000C0000110C0000000000C00000C000011
10000000000000000000000000000000000000000000001
10000000000C0000000C01000000C0000000C01000000C1
1000C0000000000C0000000000000000000000000000011
10000000000000000000000000000000000000000000001
10000C000000C0000000C00000000000000000000000001
1P000000000000000000000000000000000000000000001
11111111111111111111111111111111111111111111111